0111111111
0000000001
1000000001
1000000001
1000000001
1000000001
1011000001
1001001101
1001000101
1011111101
1010000001
1010000001
1010000001
1010000001
1111111111